1111111111111111111111111111111111111111111111111111111111111111111111111111111111111111111111111111
1111111111111111111111111111111111111111111111111111111111111111111111111111111111111111111111111111
10A000000000000000000000000000000000000000000000000000000000000000000000000000000000000000000000B001
1004444444444440044444444444444000000000000000000000000000000000000000000000000000000000000000000001
1004000000000000000000000000000000000000000000000000000000000000000000000000000000000000000000000001
1004000000000000000000000000000000000000000000000000000000000000000000000000000000000000000000000001
1004000000000000000000000000000000000000000000000000000000000000000000000000000000000000000000000001
1004000000000000000000000000000000000000000000000000000000000000000000000000000000000000000000000001
1004000000000000000000000000000000000000000000000000000000000000000000000000000000000000000000000001
1004000000000000000000000000000000000000000000000000000000000000000000000000000000000000000000000001
1004000000000000000000000000000000000000000000000000000000000000000000000000000000000000000000000001
1004000000000000000000000000000000000000000000000000000000000000000000000000000000000000000000000001
1004000000000000000000000000000000000000000000000000000000000000000000000000000000000000000000000001
1004000000000000000000000000000000000000000000000000000000000000000000000000000000000000000000000001
1004000000000000000000000000000000000000000000000000000000000000000000000000000000000000000000000001
1004000000000000000000000000000000000000000000000000000000000000000000000000000000000000000000000001
1004000000000000000000000000000000000000000000000000000000000000000000000000000000000000000000000001
1004000000000000000000000000000000000000000000000000000000000000000000000000000000000000000000000001
1004000000000000000000000000000000000000000000000000000000000000000000000000000000000000000000000001
1004000000000000000000000000000000000000000000000000000000000000000000000000000000000000000000000001
1004000000000000000000000000000000000000000000000000000000000000000000000000000000000000000000000001
1004000000000000000000000000000000000000000000000000000000000000000000000000000000000000000000000001
10044444444444400444444444444440000D000000000000000000000000000000000000000000000000000000000000C001
1000000000000000000000000000000000000000000000000000000000000000000000000000000000000000000000000001
1111111111111111111111111111111111111111111111111111111111111111111111111111111111111111111111111111