1111111111111111111111111111111111111111111111111111111111111111111111111111111111111111111111111111
1000000000220000000000000000000000000000000000000000000000000000000000000000000000000000000000000001
1004444444444440044444444444444000000000000000000000000000000000000000000000000000000000000000000001
1004000000000000000000000000000000000000000000000000000000000000000000000000000000000000000000000001
1004000000000000000000000000000000000000000000000000000000000000000000000000000000000000000000000001
1004000000000000000000000000000000000000000000000000000000000000000000000000000000000000000000000001
1224000000000000000000000000000000000000000000000000000000000000000000000000000000000000000000000001
1004000000000000000000000000000000000000000000000000000000000000000000000000000000000000000000000001
1004000000000000000000000000000000000000000000000000000000000000000000000000000000000000000000000001
1664000000000000000000000000000000000000000000000000000000000000000000000000000000000000000000000001
1004000000000000000000000000000000000000000000000000000000000000000000000000000000000000000000000001
1004000000000000000000000000000000000000000000000000000000000000000000000000000000000000000000000001
1004000000000000000000000000000000000000000000000000000000000000000000000000000000000000000000000001
1004000000000000000000000000000000000000000000000000000000000000000000000000000000000000000000000001
1004000000000000000000000000000000000000000000000000000000000000000000000000000000000000000000000001
1004000000000000000000000000000000000000000000000000000000000000000000000000000000000000000000000001
1004000000000000000000000000000000000000000000000000000000000000000000000000000000000000000000000001
1004000000000000000000000000000000000000000000000000000000000000000000000000000000000000000000000001
1004000000000000000000000000000000000000000000000000000000000000000000000000000000000000000000000001
1004000000000000000000000000000000000000000000000000000000000000000000000000000000000000000000000001
1004000000000000000000000000000000000000000000000000000000000000000000000000000000000000000000000001
1004000000000000000000000000000000000000000000000000000000000000000000000000000000000000000000000001
1004444444444440044444444444444000000000000000000000000000000000000000000000000000000000000000000001
1000000000000000000000000000000000000000000000000000000000000000000000000000000000000000000000000001
1111111111111111111111111111111111111111111111111111111111111111111111111111111111111111111111111111
