11111111111111111111111111111111111111111111111111111111111111111111111111111111
11111111111111111111111111111111111111111111111111111111111111111111111111111111
14400000000000000000000000000000000000000000000000000000000000000000000000000441
10000000000000000770000000000000000000000000077000000000000777000007777000000001
10000077000000000770007700000000000000000000000007777000000777700007777000000001
10000077000777000077000000007700077000000000000007770007700777007700777000000001
10000000000000000000000000007707700000000000077007770000007700000770000007770001
10000000000000077700000000077700000000000077777000770077000000770000000077700001
10007700007700077000077700007700077700000077777000070000000007770000000077700001
10000000007770007000077770007707700000000077007700077000000077777770007777770001
10000000007777077700000077777700000000000000007700077700000077007700000077777001
10077000077700077777000000770000000077700000007700777700007777000000000777007001
10077077777000077777700000000000000003333333000770077700007700000000007777000001
10077000077007770777700000000770007703333333000000007770007700000000000777000001
10000000077007700777700000000077007703333333000000000077000770007700000000000001
10000000000000000077700000000077007773333333000777000000000077007700770000000001
10000077000000000000000000007777007703333333000000077700000000000777700770000001
10000077000007700000000077700000007703333333700000077700000000000777700000000001
10000077000007700007700077700000000003333333700000007700000000000770007700077001
10000077000000000000777700777000000000000000000000000777777000000000000000077001
10000000007777000000777000007700077000777000007770000777700077700007700000077001
10000000007700000000077000000000000077007700000000007777000777000007770000000001
10000000777000007700000000000000770000000007700000077700000770000007770000000001
10000000777000007777000077700000000000000007700000000000000000007700770000007001
10000000077000777777700777700777000000000007700000000077000000007770000000770001
10000000000000000777000077700770000770000007700000077000000000000077000000000001
10000000000000000077000007700000000770077700000007700000000007770000000000000001
10000000007770000000000770000077000777000000000000000000000007700000077000077001
14400000000000000000000000000000000000000000000000000000000000000000000000000441
11111111111111111111111111111111111111111111111111111111111111111111111111111111
