11111111111111111111111111111111111111111111111111111111111111111111111111111111
11111111111111111111111111111111111111111111111111111111111111111111111111111111
14000000000000000000000000000000000000000000000000000000000000000000000000000041
10000000000000000000000770000000000007700000777000000077000000000000000000007001
10077700000770007770000770000007700000000000770000000000000000000777000000000001
10077000077700000000000070077007700000000000770000077700000077000770000000000001
10000000077700000007700077007000000000000000770000077770000000077700000000077001
10000007700000000000000000007700000777000077000000007700007770077770077700000001
10000770000000000000000000000000000007700000000077000000000070007777000000007001
10000000000000000000000077000077700000000000007700000000000077000000000000000001
10000000777000000000770000000007700000000007700000000000000007777000000077700001
10000000000000000000077000000000000000000000000000077000000007700000000077000001
10000077000000000777000000000770000003333333000000007700000000000000000077000001
10000000000000000770000000000000077003333333000007700000000000000000000000077001
10000000000000000000000000000007700003333333000000000007770007700000000000077001
10000000000077000000077700000000000003333333000000000000770007770077000077700001
10000007700077000000007770077000000003333333000000777000000000077000000077000001
10000000000077000000007770077007770003333333000000770077000000007700000000000001
10000000000000077700007770077000777003333333000000070000000000000700000000000001
10000000007770007700077777000007770000000077000770077000000000007770000000000001
10077000000077000000077777700007700000000077000000777000000000007700000000000001
10077770000077777000777000000000000000000000777000770000000000000000000000000001
10007777000000777700770000000000000000000000777000770000000000000077000000000001
10007700000000000000000000000770000000077000000000770000000000007700000000000001
10000000077000000000000000077770000000007700000000000000000000770000000077000001
10000000000000000000077000000770000000007770000077000000000000000000000000000001
10000000000000000000077700000000000000000077000000000000007770000000000000077001
10000000007700000000000770000000077000000007700000000000000000000000000000000001
14000000000000000000000000000000000000000000000000000000000000000000000000000041
11111111111111111111111111111111111111111111111111111111111111111111111111111111
