11111111111111111111111111111111111111111111111111111111111111111111111111111111
11111111111111111111111111111111111111111111111111111111111111111111111111111111
14000000000000000000000000000000000000000000000000000000000000000000000000000041
10007700000000000000000000000000000000000770000000000000000000000000000000000001
10000000000000000000000000770000770000770000000007770000000000077000000000000001
10000000000000000000000000777000000000000000000000077000000000000000007700000001
10000000000000000000770000777000000007700000000770000000000007700000000000000001
10000000777000000000000007700000000007700077000077000000000000000000000000000001
10000000770000000000000000000000000007700000000000000000770000000007700000000001
10000000000000000007700000000000000000000777700000000000000770000000000007700001
10000000000000000000000000000000000000000777770000000000000000000000000000000001
10000000000000777000000000007770000000007700000000000000000000000000000000777001
10000000000000770000000000007700000003333333007770000077700000000000000000770001
10000000077777700000000000770000000003333333007700000000770000000000000000000001
10000000077007700000007700000000000003333333007700000000000000000000770000000001
10000000000000000000000000000007770003333333007700077000000000000000000000000001
10000077000000077000000000000007700003333333000770000000000007700000000000077001
10000000077700000077000000007700000003333333000770000077000000000007770000000001
10000000007700000000000000000000077703333333000770000077000000000000000000000001
10077000000000000000000000000000000000000077000770000077000770000000000000077001
10000000000000000000000000770077000000770000077700000000000000000000000000000001
10000770000000000000000000000077700077000000077700000000000000000000077000000001
10000000000000000000000000000077000000000000000000077700000077000000007000000001
10000000007770000000000000000000000000000000000000077000000077000000007700000001
10000000000000000000000000000000000000000000000007777000000000000000000000000001
10000000000000000077000000007700000000000000000000007700000000000000000000007001
10000000007700000000007700770000000077000000770000000000000000000000000000000001
10000770000000000000000000000000000000000000007700000000000000000000770000000001
14000000000000000000000000000000000000000000000000000000000000000000000000000041
11111111111111111111111111111111111111111111111111111111111111111111111111111111
