11111111111111111111111111111111111111111111111111111111111111111111111111111111
11111111111111111111111111111111111111111111111111111111111111111111111111111111
14000000000000000000000000000000000000000000000000000000000000000000000000000041
10000000007700000770000007700000000077000000000000077000000770000000007770000001
10000007700000000000770000000000000000000000000000000000000777000770000000000001
10077000000000000000000770007700000000000000000000000000000007700000077000770001
10007700000000000000000000000000077000000000000000000000007700000000007700070001
10007770000077000000000000770000000000000000000000000000000000077007777000077001
10077700000000000000007770770770000000077700077700000007700000000000077007700001
10007700000000000000007700770000000000000700007700000000000007770000000000000001
10000000000077000000000700000000000000000770007700077700000007770077000000000001
10000000000077000000000770000000000000770077007700077000000007700000000000770001
10000000000000000000000000000000000003333333007770000000000000000000000000770001
10000000000000000000770000000000000003333333007770000000000000000000000000070001
10000000000077000770077007700770077703333333000777000000770000000077000000077001
10077000777077000000000000700000077703333333770000000000777007700077000007700001
10000000077077000000000000770000000003333333777000000000000000770000000000000001
10000000077000000000000077000000000003333333000000777700000000000000000077000001
10000000077700000000000077000007770003333333000000000000777000000000000000000001
10000000077000000770000077000077700077700770000000000000077000007700000000000001
10000777000000777700000077000077700000000000000000000000000077700000000000770001
10000777000000077700077000000007700000000000777000000770000077000000000077000001
10000770007700007700077000000000770000007700000000000000770000000000000000000001
10000770007700000777770000077000000000000700000007700000070000777000777000000001
10000000000000000007770077000000000000007770000770007700077000777700000000000001
10077000000000000000770000000000000000007700770000000000000000000770000000770001
10077700000077000000770000000000770000000000000000000000000000000000000000000001
10077000000770000000770007700077000000000000770000770007700000000000000000770001
14000000000000000000000000000000000000000000000000000000000000000000000000000041
11111111111111111111111111111111111111111111111111111111111111111111111111111111
