11111111111111111111111111111111111111111111111111111111111111111111111111111111
11111111111111111111111111111111111111111111111111111111111111111111111111111111
14400000000000000000000000000000000000000000000000000000000000000000000000000441
10000000000000000000077000000077000000000000000000000000000077000007700777000001
10000007700000000000077007700007700000000000000007700000770000007770077770000001
10000000770000000000077000007707770007700000000000000000777000000000007770000001
10007700000007700000000000000007777000007700770000000000777007770000000770000001
10000000000000000777000000000000777000000000000000000000777007700000770000000001
10000000000000000007770077000000077700000077000000000000077000000000000000000001
10000000000000007700777777700000077700077700000077007700077000000007700770077001
10000770007700007700000777700000077000077700000007700000077000000000000070000001
10000000000000007700000077700077007000000000000000000007700000077000000077007001
10000000000000000000000077770000007703333333077000000007770000077000000007000001
10000777700000777000077770000770007703333333700000000007777000000000000007700001
10000770000000777000000770000000000003333333000000000007770000000077700000700001
10000770000000000000000000000000000003333333000770000007777000000077000000770001
10000077000000000000000000000000000773333333000077000007777700000000000000077001
10000000777700000007777000000007700003333333000077700007700000770000000770000001
10000000777000000000777000000000000003333333000770000000000000000000000000000001
10000000000000000000077000000770000077770007770000000000000770000000000000077001
10000000000000000000000000000000000000770000777000000000000000777007777700077001
10000770000000077000000770000000000000000000077000000077770000770000007770000001
10000070000000077000000070000000000000000000000000000007777000770000007700000001
10000077000000077007700077000000077770000000000000000007770000000000007770007001
10000077000777700007700077000000077000000007770000000007770000000000000777007001
10000007000000000000770077000000000000000000000077000077770000000000000077007001
10000007700000000000077000007777000770000000000000000000770077000000777000000001
10000077000000000000000007770077000077000000777700770000000770000000000000770001
14400000000000000000000000000000000000000000000000000000000000000000000000000441
11111111111111111111111111111111111111111111111111111111111111111111111111111111
