11111111111111111111111111111111111111111111111111111111111111111111111111111111
11111111111111111111111111111111111111111111111111111111111111111111111111111111
14000000000000000000000000000000000000000000000000000000000000000000000000000041
10000000000000000000000000770000000000000000000000000007700000000077007770007001
10007700007700077000000000770000000000000000770000000007700000000000007700000001
10007700007700000007700000770000770000000007777000777000000000077000000000000001
10000000000000000007700000770000000000077007777000077000000000007000000000000001
10000000000000000000000000770000000000000000077000000000000777007700000000000001
10000000000000000000000000000000000000000000000007700000770007000000000000000001
10077000000000000000000000000000000007700000000000007777770007700000000000000001
10000000000000000000770000770000000000000000077000000077000007700077000000000001
10000007700000007770000000000000000000000000000000000000000007700007700000000001
10000000000000007770007770000000000003333333000000000000000777700000000077000001
10000000000000077700000077000000000003333333000000000770000007700077000000000001
10000000000000077700000000000007700003333333000000000000000000000000000000000001
10000000000000007770000000000000770003333333000000000000077000000000000077000001
10000000000000000077000000077700000003333333000000000000007007770000077700000001
10000770000000000077700000000770000003333333000000000000007700077000077000000001
10000000000000000077000000770000000003333333000000000000000000077700000000000001
10000000000000000000000000000000000000000000000000000000000000000007770000000001
10000000000000770000000000000000000770000077000000000000000000000000000007700001
10000000000007770000077000000000000770000000000000770000770000000000000770000001
10000000000007700000077000000007700000000000007777770000000000000770000000007001
10000000077000000000000000000000000000000077700077770000000000770000007700000001
10000000000000000770000000007770000000000000770077000000000000000000000000007001
10000000000000000000000000000000000077700000000077000000000000000770077000000001
10000000000000000000000000000000000000770000000077000000770000000000000000000001
10000007700000007700000000000000000000000000000000000000077770000000000000000001
14000000000000000000000000000000000000000000000000000000000000000000000000000041
11111111111111111111111111111111111111111111111111111111111111111111111111111111
