11111111111111111111111111111111111111111111111111111111111111111111111111111111
11111111111111111111111111111111111111111111111111111111111111111111111111111111
14000000000000000000000000000000000000000000000000000000000000000000000000000041
10000000000000000000000000000000000000000000000000000000000000000000000000000001
10000007700000000000007770000000000000077700000000000000000000000000000000000001
10000000770077000000000000000000000077770000000000000000000000000000000000000001
10007700000000000000770000000770000000770000000000000000000000000000000000000001
10000000000000000000000000000000000000000077000000000000000000000000000077000001
10000000000000000000000000000000000000000007000000007700007770000770000000000001
10007700770000770000000007770000000000000007700007700770000000000000000000000001
10007770000000770007700000077000077000000000000000770000000000077000000000000001
10007777000000077000007700000077000007700000000000000000000000000000000000000001
10007700000000077000000000000000000003333333077000000000000000000000000000000001
10000000077000077000000007700000000003333333000000770000077000000007700000000001
10000000000000000000000000000000770003333333000770000077000000000007700000770001
10000000000000000000077700077000070003333333000000000007700007700007700077000001
10000007700077700000000770077000077003333333000000000000000000000000000000000001
10000000000007770000000770000007700003333333700000077000000000000000077770000001
10000770007700770000000770000000000003333333000000000000000077000000000000000001
10000770000000070000000770000000000000000077000000000000077700000000770000000001
10000000000000077000000770000000000077000000077000000770077000000000000000000001
10000000007700000000000770007700000000000000077000000000000000000777000000077001
10000007700000000000000770000000000000000000000000000000000000077777700770000001
10000007700000000770000000000000770000000000000000000000000000007777700000007001
10000007700000770000000000000000777000077000000000000000000000000007770007700001
10000000000000000000000000000007700000000077000000000000000000000000000000000001
10000000077000000007700077000000000000000007700000000000007700007770000000000001
10000000000000000000000000000007700000000000000077000000007700007700000000000001
14000000000000000000000000000000000000000000000000000000000000000000000000000041
11111111111111111111111111111111111111111111111111111111111111111111111111111111
