11111111111111111111111111111111111111111111111111111111111111111111111111111111
11111111111111111111111111111111111111111111111111111111111111111111111111111111
14400000000000000000000000000000000000000000000000000000000000000000000000000441
10000077000000000000000000000000000000000000000000000000000000000077000007700001
10000000770000000000000770000000000000000000000000000000770000000000000000000001
10000000000000000000000000000000000000000000000000000000000000007700000000000001
10000000000077000000000000000000000000000000000000000770000000000000000000000001
10000000000000000000000000000000000000000000000000770000000077000000007700000001
10000000000000000000000000000000000000000000000000000000000000077000000000000001
10000000000000000000000007700077000000000077000000770000000000000007700000000001
10000000000000000000000000000000000007700000000000000000000000000000000000000001
10000000000000000000000000000000000000007700000000000000000000000000000000000001
10000000000000000000000000077000007703333333000770000000000000000000077000000001
10007700000000000000000770000000000003333333000000000000000000000000000000000001
10000000000000077000000000000000000003333333007700770000000000000000000000000001
10000000000000000000000000000000000003333333000000000000000000000077000000000001
10000000000770000000000000077000000003333333000000000000000000770000000000000001
10000000000000000000000000000770000003333333000000770000000000000000000000000001
10000000000000000000000000000000007703333333000000000000000000000000000000000001
10000000000077000000000000000770000000000000077000000000000000000000000000000001
10000000000000000000000000000000000000000000000000000000077000000000000000000001
10000000000000000007700000000000000000000077000000000000000000000000000000000001
10000000000000000000000000000000000000000000000000000770000000000000000000000001
10000000000000000000000000000077000000000000000000000000000000000000000770000001
10000000000000000000000077000000000000000000000000000000000000000000000000000001
10000000000000000000007700770000077000000000000000000000000000000000770000000001
10000000000077000000000000000000000000000000000000000000000000000000000000000001
10000000000000000000000000000000000000000770000000000007700000000000000000000001
14400000000000000000000000000000000000000000000000000000000000000000000000000441
11111111111111111111111111111111111111111111111111111111111111111111111111111111
