11111111111111111111111111111111111111111111111111111111111111111111111111111111
11111111111111111111111111111111111111111111111111111111111111111111111111111111
14000000000000000000000000000000000000000000000000000000000000000000000000000041
10000000000000000000000000000000000077000077000077000000000000000000000000000001
10000000000077000007700000000077700077000000000007700000000000000077000000007001
10000007700077700000770000000077700077000000000000000770000000000000077700007001
10000007700007770000000000000000770007700077700000000077000007700000000770000001
10000000000000000000000000000000000000770007700000000007700000000777770000000001
10007700000000000000007700000770000000000000007770000000000000000770000000000001
10007700000000000000000000000770000000000000007777777770077000000000007770000001
10000770000000000000000000000000000000000000000000770077000000777000000077000001
10000070000000000000770000000000007700770007777000000000000000777007700000000001
10000077000000000000000000770000007703333333077000000000000000777000700000000001
10000000007700770000000000000077000003333333077700000000000000007700770000770001
10000000000000777000000077000000000003333333000000000000000000000000077000777001
10000000000000777000000007700000000003333333000000770000000000000000000007700001
10000770000000777000000007707700000003333333000000077000000000007700000000000001
10000000000000077700770007700000000773333333700000007770000000000000000000000001
10077700770000000000000000000000000073333333007777700077007700000000000777770001
10077770000000000000000077700000000777000000000777777770000000000000000777777001
10077000000000000000000077770000000770000000000777007770000007700000000007700001
10077700000077000000000007700007700000000000000077000777000000000000000000000001
10000770000077000000000000000000770000000000000000000770000000007700000000000001
10000000000077000000777700000000000777700000077000000000000077700770000000000001
10000000000000000000000770000000000077700000000000007770077007770000000000000001
10077770077700000000000000000000000000000077700007700077000000000000000000077001
10077770007770000000077000000000000000000000000007700000000077000000000000000001
10000077000770000000077777000077700000000007770007700000770077000770000770000001
14000000000000000000000000000000000000000000000000000000000000000000000000000041
11111111111111111111111111111111111111111111111111111111111111111111111111111111
