1111111111111111111111111111111111111111111111111111111111111111111111111111111111111111111111111111
1111111111111111111111111111111111111111111111111111111111111111111111111111111111111111111111111111
1440000000000000000000000000000000000000000000000000000000000000000000000000000000000000000000000441
1000000000000770000000000007700000777000000777000000000000000000000000000000000000000770077000000001
1000000000000777000000000007770000000000000777000000000000777000000000000000000000000770077777777001
1000000000000777000000077007770000000000000007700000007700777000000000000000077000077777077777770001
1000000077007700000000007700770007700000000000000007700000077000000000000000777000000000077777000001
1000000077000000000777700000000770077700000000000000000000077000077700000000770007770000000077777001
1007770077700000000077770000000000077000000770000000000000777000007770077000000007700000000007777001
1007700007700077000077770077770000000000000770000000000000777000007700077000000007700000000000770001
1000000007700007700000770077770000000000000000770000000000077700770000007700000000000000000000000001
1000077007777700000000000077770000000000000000000007770000000000000000000000000000000000770000000001
1007700007777770000000000077000077700007700000033333330077770000000000770000000007700000000000000001
1000000077007700000000770000000007770000000770033333330077777000000000777000000000000000000000000001
1000000000007700000000077000000000770000000000033333330770007700077700777700777000000000000007700001
1000000000000000000000000077770000000000000007733333330770000770007770077000007700000000000007700001
1000000077000000007700000007770077000000000000033333330770000777000770077007700000000770007700770001
1000000000000000000000007700770000000000000000033333330777000777000077770007770000000770000000770001
1000000000077000000000007700000000000000000000033333330777007700077077770000777000777000777000770001
1000007700000007700777707707700000000000000000000000000777000000007007770000770000000000770000770001
1000007770000000000770007700770000000777777000000777007777000000007700777700770000000000770000770001
1000770077000777007777000700000000770007700000000777700007700000000000007770000000000000077000770001
1000770007700007700007777770007700770000000777000007770000000000000077700777770000000000000000770001
1000777700000000000007777000007700777000000000000000770000077000000000770000777700000000000770000001
1000007770000000000777000000000000000000000000000770000000000000000770000000777770007770000770077001
1000000770077000770077000000000077700000777000000077000007770000770777000077777770770077000770077001
1000000000000000077000000077000077700000000000000000000000077000000077700077700770000000000770077001
1000000770007700000000007700000000000000000077000000770000077000000770007700777000000000000000007001
1440000000000000000000000000000000000000000000000000000000000000000000000000000000000000000000000441
1111111111111111111111111111111111111111111111111111111111111111111111111111111111111111111111111111
