11111111111111111111111111111111111111111111111111111111111111111111111111111111
11111111111111111111111111111111111111111111111111111111111111111111111111111111
14400000000000000000000000000000000000000000000000000000000000000000000000000441
10000000000000000000007700000000000007777000770000000770000007700077000000000001
10000007770000077007777000000000000000000000777000770000000000700077700077000001
10000007777000007700077000777000000000000007770000000000000000770000770007007001
10000077700000000000000000007700770000077007770000000000000000770770000007700001
10000007700000000000000077700770077007777000077000000007770007777700000000000001
10007700770000000000000000777777077000007700000000000007700000077700007700007001
10000000077700077000000000777700077000000000000000077700770077077700000700077001
10077000007770000000000000007770000000000000000000077777777000007770000770077001
10077000000077000077700000000077000077000000000077007777007700000000000000077001
10077777700000000000770000000077000003333333000000007700007700077007700000077001
10077770000000777000000007700077000003333333000000000000007770000000700000077001
10077777000077007700000000000000000773333333000000000000000770000000770000077001
10000077700000000000077000000000000773333333000000007700000000000000000000077001
10000000777700000000000000000000007703333333000077000000000000000000000000077001
10000000770000000007700000000000000003333333000000000000000000000000000000000001
10000777000000000000000007770000077003333333000000000000770000000000000000770001
10000000000000000000000007700000000000077000000000000000000077700000000000000001
10000000000770000000000077700000000000077000000000000000000077000000007700000001
10000000000000000077770077000000077007700000000000000007700000000000000770000001
10000000000000000007777000000007700077700000000000000000000000000077700000000001
10000000000777007700000000000000000077000077000000000770007777000000077700077001
10000000000007700000000000000000000077007700000000000777000007700770077000000001
10000000000000000000000007700000770077007700000077700077000000000000000007700001
10000000770000000000000000000000000000007700770077700007700770000000000770000001
10007777700000000770000000000000000007700000770000000007700000000000077000770001
14400000000000000000000000000000000000000000000000000000000000000000000000000441
11111111111111111111111111111111111111111111111111111111111111111111111111111111
