11111111111111111111111111111111111111111111111111111111111111111111111111111111
11111111111111111111111111111111111111111111111111111111111111111111111111111111
14400000000000000000000000000000000000000000000000000000000000000000000000000441
10000000000000007700000000000770000000000077000077700770000000000000770000000001
10000000000007777000000777777700000000077000000777777777700000770000000000000001
10000000000000000000000077770000000007700000077777707770000000077770000000000001
10077700000077000000000077700000000000000000777777707770000000007777000770777001
10077000777700000077700770000000000000000007770077700770000000007770077007770001
10077000770000000077700070000007700000000007777000700000000000000777770007700001
10000000777700000007770077007707700000000000007700770000000000000777770007700001
10000007777770000000077000000007700000000000000000000000000007700777770000770001
10077707700000007700000000000000770000077000000000000000000000007700777000000001
10077007700000000000000000000000000003333333007770000000000000007700777700000001
10000000770000000077000000000000000003333333007700000007700770077700000777000001
10000000777000000077000000777000000003333333000000000000000000077000000007700001
10000000777700007700000007770000000003333333077000000000000000077000000000000001
10000000007770000000000007700000007773333333077007777000000770077700007777777001
10000077000000077000000000000077000003333333077700077700077000770000000077700001
10000077700007700000777700000000000003333333770000077700077000000000000077000001
10077000770007700077000700007700000000770007770000077000077000000000000077000001
10000000000077770000000770000000000000777007700000077000077000000000770000077001
10000000000077700000000077000000000000077777000007777000000077000000000770077001
10000000000000000000000000000000770077000777000000777000000077000000000000777001
10007700000000000000000000000000000077007770000000000077700777777700770000777001
10000000007700000000000000000000000077007700007770000007700007777000000077700001
10000000000000007700000000000000000000000000000777000000770000000000000077700001
10000007700000007700077700000000000000000000000077000000000000000000000000000001
10000000000000000000000770000000777000000000000077000000000000000000000000770001
14400000000000000000000000000000000000000000000000000000000000000000000000000441
11111111111111111111111111111111111111111111111111111111111111111111111111111111
