11111111111111111111111111111111111111111111111111111111111111111111111111111111
11111111111111111111111111111111111111111111111111111111111111111111111111111111
14400000000000000000000000000000000000000000000000000000000000000000000000000441
10000000000007770000000077000000077000000770000077000000000000000777000000000001
10000770000000077000077077770000077000000077700000770000777700000000000007700001
10000000007700000000000007700000077000000007700000070000007770000000000007700001
10000007700000000000770000000000077700000000000000077000000770000000000000000001
10000007770007770077000000000000000770077000000007700000000770000000077700000001
10000007777000070000000007700000777770000077007707700000000000770000077000000001
10000777700000077000007770077700077770000077000007770000007700000000000000007001
10000777700000077000000000777000000000000000077007700000000770000000000000000001
10000770000000077000777000777000000007770000000077700007770000770000000000000001
10000770000000077000000000777000000003333333000777000000000000000000000000077001
10000770077000000000000000077000000003333333077000000770000777007700000000000001
10000070000000000000000077000000000003333333700000770000770007700007770000000001
10000077000077007700000077700000007703333333000777000000770007700007700000000001
10000000000000000000000007770000007773333333000770000000000077700007700007770001
10000770000000000000077700770000007773333333000770007700000000000000770000077001
10000000000000000000077700770770077003333333077770000007700000000000000000000001
10000000007700000000007700770000000000000770000770000000000000000000000007700001
10000770000000777007700770000000000000000777000000000000000000000000000000770001
10007770000000000000000077007700000777700777700000000000000000000000777000000001
10007770000000000000000000000000000777000777770000000000000000007700777000000001
10000000777000007770007770000000000777000777000000000000000000007700777700000001
10000000000000770000000000000000000000000077000770007700007770000000777700000001
10000000000000000000077007700000000000000000000000000700007700000000077700000001
10000000077700000000007700000077007700000000000007700770007700000000007700000001
10000000077770000770007700000000000000000007700000077700000000000000000000077001
14400000000000000000000000000000000000000000000000000000000000000000000000000441
11111111111111111111111111111111111111111111111111111111111111111111111111111111
