11111111111111111111111111111111111111111111111111111111111111111111111111111111
11111111111111111111111111111111111111111111111111111111111111111111111111111111
14400000000000000000000000000000000000000000000000000000000000000000000000000441
10077000000007700000000000000077700770000000000077000000000007700007700000000001
10077077700000000000000007770007700770077000000000000000000777000770000000007001
10077000000777000000000000000007700770000077770000000000000077000000000000000001
10000000000777000000000000000007770077000077777007700770000000000000077000000001
10000000000077700007700007700000770007700077000000000000000000077700077000000001
10000000000077000007700000000000777000000000000000000000007700000000077007700001
10000007700000000007700000000007700000000000007770000000007770000000000000000001
10000000770000000770000770000007700000777000777700000000000770000770000000000001
10000000770000000000000077000777000000777700007700000000000000000070077700000001
10000000777000000000770000000077000003333333000777000000077700000077077770000001
10000770000000007700000000000000000003333333000077700007700000000000007770000001
10000000000000000000000077000000000073333333000077700000000000000000000770000001
10000000000000777000000077000077000003333333000007770000000000000077000070000001
10000000000000000000000000000077000003333333000000777000000000007700000077000001
10000000770077000000000000000000000003333333000000777000000077000000000077700001
10077000000000077000770000770000007773333333000077770000000077700000000007700001
10000000000000000000000000000000077700000007770077770000000077770077000007700001
10000007700077770000000077770000077770000007777000770000000077000077000007700001
10000000000077770770000007777000000777000000770000077000000000000077000000770001
10000000000077770000077777000000770077700000000000077700777000007700000000000001
10000077700777000000007777000000000000000000000000077000777000000000000000000001
10000007770077000000000077000000000000000000000000000000007700000007770077000001
10000000000077000000000000000000000000000000077000000000000000000007700007000001
10000000000000007700000770000000000007700007700000000007700000000007700007700001
10000000000007700000077000077007700007700000000000000000077007770000000000000001
14400000000000000000000000000000000000000000000000000000000000000000000000000441
11111111111111111111111111111111111111111111111111111111111111111111111111111111
