11111111111111111111111111111111111111111111111111111111111111111111111111111111
11111111111111111111111111111111111111111111111111111111111111111111111111111111
14400000000000000000000000000000000000000000000000000000000000000000000000000441
10000077700000000000000000000000000000000000000770077000000000000000000000000001
10007700000000777000777777700000007700000077770077000000007700000077000077700001
10000000000000007700000777700000007770000000077770000000000000000000000077000001
10077777770000000000000077700000007777000000077770000770000000077770007777000001
10000777700077770007700077000000000077000000077000000770000000077000000777000001
10000007700007777000700077000000000000000000000000000777000007700000007777000001
10000000007700777000777000007777777000077000000000000777000000000077777700000001
10000077000000777000077700000077007700077000777000000777000000000077770000000001
10007700000000077700077700000000007700077000770000000000000000000077000000000001
10000000007700000777007700000000007703333333000000777000000000000777000000000001
10000000000000000777700000000000000003333333000000777700000000000770000000000001
10077770000000000770000000000000770003333333000077770007700000770000000000000001
10007700770000000000000000000000770003333333000007770077700770000000000000000001
10000700000007770000000000007777777003333333000000770077000000000000000000007001
10000770000777700000000000000777007703333333700000000777000000000000770007777001
10077700000000000770077000000000000003333333000000000777000000000000000000077001
10007700007700077000000000077000000000000770000770000077000000007777700770000001
10000000000000000000000000000000000000000070000000000000000000000777700000007001
10000000000007700000000000000000777007700077000000000000000007700007700000000001
10007770000007700770000000077700077007700000000077000000000000007700000000000001
10007700000000000000000777000000000777700000000000000000000000000000000000777001
10000000770000000000000770000000000770000000007777000000007770000000000000000001
10000000000000000000000000000770000000000000770777700077007700000000000777000001
10000000000000000000770000000000000000000000770077700007700000077000000770000001
10000007700000000007770000077000000000000000000000000770000000000000000000770001
14400000000000000000000000000000000000000000000000000000000000000000000000000441
11111111111111111111111111111111111111111111111111111111111111111111111111111111
