11111111111111111111111111111111111111111111111111111111111111111111111111111111
11111111111111111111111111111111111111111111111111111111111111111111111111111111
14000000000000000000000000000000000000000000000000000000000000000000000000000041
10000000000000000000000000077000000000000000000000000000000000000000007700777001
10000000000000000000000000000000770000000000000000000000000000000000000000077001
10007700000000000000000000000000077770077007700770000000000000000770077000007001
10000000077000770000000000000000077000007700000000000000000000000000000000000001
10000000000000000000000000000000000000007770000000000077000770007700000000000001
10000000000000000000000000777700000000000770000000000000000000000000000007700001
10000000000770000000000000000000000000000777000007700000077000000000000000000001
10000000000000007700000000000000000000000777700000000000007777700000777700000001
10000007700007770000000007700077000000000770000000000000007700770000770000000001
10000000000077777007700000000000077003333333000000000000000700070000000000000001
10000000000000007777000000000000000003333333000077000000000777777000000000000001
10000000000000000777007770000000000003333333000007000000000007700000000000000001
10000000077000000077777000000000000003333333000007700007700000000000000000000001
10000000007700000007777000000000000003333333000000000007700000000000000000000001
10000007700000000000000000000007700073333333000777000007700000000000007700000001
10000007770000000077000000077000000003333333000777007700770000000000000000000001
10077700077000000077000000000000000000000000000770000000000000000000000000000001
10077700000000000000000000000000000000000000000000000000000000000000000000077001
10007770000000007700000000000000000000077700000000000000000000000000000770000001
10077700000000000000000000000000000000077700770000000007700000000000077000000001
10077000777000000000000000000000000000000770000000770000000077000000000000000001
10077000770000000000000000007700000000000000000000000770077700000000000000000001
10000000770000000007700000000007777000000000000007700077000000000000000007700001
10000007770000000770000000000000077700007700000000000000000077700770000000000001
10000000000000000000000000000770000007700000000077000000000000000000007700007001
14000000000000000000000000000000000000000000000000000000000000000000000000000041
11111111111111111111111111111111111111111111111111111111111111111111111111111111
