1111111111111111111111111111111111111111111111111111111111111111111111111111111111111111111111111111
1111111111111111111111111111111111111111111111111111111111111111111111111111111111111111111111111111
1440000000000000000000000000000000000000000000000000000000000000000000000000000000000000000000000441
1000000077000770000000000077700000000770000077000000000007700000000000000000000077700000000770000001
1007700777000077000000770000770007777000000077000000000000700000000007700777700000770000000770000001
1000000777000007700000777000770000777000000000007777000000770000000000770007770000000000000770077001
1000000077700000000770777000770000077700000770000777777000000000000000000000770077007700000077777001
1000000000000770000000077700000000000007777777000007777700000000000000007700000000000000000077770001
1007777700000000077000000000007700000007777700077007777000000000000000770000007777000077000077700001
1007700770000000077700000000000000000000770000000000777000000000000000770000000777700077000007700001
1007700777000000077000000000000000000000000000000000007777700077000000000000000077700000000007700001
1007700000007770077000000000000000000777007700770000000077770077700000000000000007700000000007700001
1007777000007770007700770000000000000777707700033333330007777000700000000007700000000000000007770001
1007777700000770000000000007700007700077707700033333330000777700777000000077700000000000000007700001
1007770000770000000000000007700007770007700000733333337000007770007700000077700000000770000000000001
1000770000770000000770007700000007770000000000033333330000000000000770000000770000000077000000000001
1000770077000000000077007770000077000770000000033333330000000000000000000000000000000000007777000001
1000070000000000077000000770000777000000077000033333337700077000000000000077000000000000000077000001
1000077000077700000000000777007770000007700077033333337700077000000000000000000000000007700000000001
1000000000077770000000770077000000000000000000000000007700077000000007700770000007700000777700000001
1000000000077770777700000000000000000077700000000000007770077000000000000770000007770000770000007001
1000077000077770077770000000000000770000770007700000000077007700077000000770000007700000000000000001
1000077000007777007770000770007700000000077000000077000000000000000000000777000007700077700000000001
1000077700007700000000000000000000000000000000000077700000000000000000000007700000000777007700000001
1000000000007700000000777000000000000000000000770000007700000770000000000000770000000770007700000001
1007770000007700000000770007770000000000000000000000007700000000000000077700077000000000000000000001
1007700000000000000000000000777000000000770000007700007700007700000007700770000000000000000000000001
1000007770000000000000000000077000077700077000000000000000007700000000770077000000000000000077000001
1440000000000000000000000000000000000000000000000000000000000000000000000000000000000000000000000441
1111111111111111111111111111111111111111111111111111111111111111111111111111111111111111111111111111
