11111111111111111111111111111111111111111111111111111111111111111111111111111111
11111111111111111111111111111111111111111111111111111111111111111111111111111111
14000000000000000000000000000000000000000000000000000000000000000000000000000041
10000000000000000000000000000000000000077000007770000000000000000000000000000001
10000000770000000000000077700000000000077700007700077700000000770000077700000001
10000000000000777777700077000077000000007700000000077000000000070000077000000001
10000000007700077777000000000077000077700000000007700000077700077000000000000001
10000077000000007777000000000077000000000000000000000000000777000000770000000001
10000000000077077700000000770000077700000000077000000000000007700000770000000001
10007770000077077000077000070000000007700000000000000000770000000000770000000001
10007777000077000007700000077000000000000000000000777770000000000000000777000001
10077700000000000007700000000000000000000000000000077770000000000000000777000001
10007700000000000077700000000000000003333333000000000777000077700007700007700001
10000000000000000000770000000000777003333333000000000777000077000000000000000001
10000007700000000000777007700000077703333333007770000777000000000000000000000001
10077777700007700000000007700000000003333333700770000077000000077700000000770001
10000777000007700000000007700777000003333333700000000000000007700000000000070001
10000077000000000000000007700077700773333333000000007777000000000007700000077001
10000000000000000000077007770000000773333333077000000077700000000000000000077001
10000770000077007700000000000000000770000000077000000077700000007700000000077001
10000777000000000000000077007700000770007700777700000007700000000000000000000001
10000077777770077000000007700000000000007700777000777000000000770000000000000001
10000000077000077000000007770000000000000000077000077777777000770000000000007001
10000000007000000000000000770000000000000000007000000777777700770000000000000001
10000000077700000007700000000000000000077000007770000007700700770000000777000001
10000000077000777007770000000000770000000000000077000007700770077007700077700001
10077000000000077000077000770000000000000000000000000007700000000007770000000001
10000000000000000000000007700000000000000000000007700000007700770000000000000001
14000000000000000000000000000000000000000000000000000000000000000000000000000041
11111111111111111111111111111111111111111111111111111111111111111111111111111111
