1111111111111111111111111111111111111111111111111111111111111111111111111111111111111111111111111111
1111111111111111111111111111111111111111111111111111111111111111111111111111111111111111111111111111
1002222222222222222222222222222222222222222222222222222222222222222222222222222222222222222222222001
1224444444444444444444444444444444444444444444444444444444444444444444444444444444444444444444444221
1224444444444444444444444444444444444444444444444444444444444444444444444444444444444444444444444221
1224444444444444444444444444444444444444444444444444444444444444444444444444444444444444444444444221
1224444444444444444444444444444444444444444444444444444444444444444444444444444444444444444444444221
1224444444444444444444444444444444444444444444444444444444444444444444444444444444444444444444444221
1224444444444444444444444444444444444444444444444444444444444444444444444444444444444444444444444221
1224444444444444444444444444444444444444444444444444444444444444444444444444444444444444444444444221
1224444444444444444444444444444444444444444444444444444444444444444444444444444444444444444444444221
1224444444444444444444444444444444444444444444444444444444444444444444444444444444444444444444444221
1224444444444444444444444444444444444444444444433333334444444444444444444444444444444444444444444221
1224444444444444444444444444444444444444444444433333334444444444444444444444444444444444444444444221
1225555555555555555555555555555555555555555555533333335555555555555555555555555555555555555555555221
1224444444444444444444444444444444444444444444433333334444444444444444444444444444444444444444444221
1224444444444444444444444444444444444444444444433333334444444444444444444444444444444444444444444221
1224444444444444444444444444444444444444444444433333334444444444444444444444444444444444444444444221
1224444444444444444444444444444444444444444444433333334444444444444444444444444444444444444444444221
1224444444444444444444444444444444444444444444444444444444444444444444444444444444444444444444444221
1224444444444444444444444444444444444444444444444444444444444444444444444444444444444444444444444221
1224444444444444444444444444444444444444444444444444444444444444444444444444444444444444444444444221
1224444444444444444444444444444444444444444444444444444444444444444444444444444444444444444444444221
1224444444444444444444444444444444444444444444444444444444444444444444444444444444444444444444444221
1224444444444444444444444444444444444444444444444444444444444444444444444444444444444444444444444221
1224444444444444444444444444444444444444444444444444444444444444444444444444444444444444444444444221
1224444444444444444444444444444444444444444444444444444444444444444444444444444444444444444444444221
1224444444444444444444444444444444444444444444444444444444444444444444444444444444444444444444444221
1002222222222222222222222222222222222222222222222222222222222222222222222222222222222222222222222001
1111111111111111111111111111111111111111111111111111111111111111111111111111111111111111111111111111
