11111111111111111111111111111111111111111111111111111111111111111111111111111111
11111111111111111111111111111111111111111111111111111111111111111111111111111111
14000000000000000000000000000000000000000000000000000000000000000000000000000041
10007700000000000000000000000770000000000000000000000000007700000000000077000001
10000000000000000000000000000077000000000000000000000000000007700077700007700001
10000000077000000007770000000077000000000000000000000000000000000077700007770001
10000000007700000007700077000077700000000000007700000000000000000007700000077001
10000000000007700007700000000000770000000000000000000000000007770000000000000001
10007700000000000007700000000770077000000770000000000000000000770000000000000001
10000770000077000000700000000000000007700000000000000000000000000000000000000001
10000000000000000000770000000000000000700000000000770000000770000000000000000001
10000000000000000000070000000000000000770000000000000000000070000000000000000001
10000000000000000000077000000000000003333333000770000000000077000000000007700001
10077000000000000000000000000000007703333333000000000770077077000000000007770001
10077000000000000000000000000000000703333333000000000770000077000000077000770001
10000000000000000000000000000077000773333333000000000777000000000000000000000001
10000077700000000000000000000000000003333333000077000007770000000000770000000001
10000077000000000000000000007700000003333333000000000007777000770000000000077001
10000000000000000000770000000007700773333333000000000000770000070000000000000001
10007700007700000000770007700000000000000000770000000000070000077000000000000001
10000000000000000000000000000000000000770000077000000000077000000000000000770001
10000077700000000007700000000000000000000000000000000000000007700000077000000001
10000000770000000000000000000000000000000000770000000000000000000000000000000001
10000000000000000000000000000077000000000000070000000000000000000000000000000001
10000000000000000000000000000000000000000000077000000000000000770000000000007001
10000000000000007700770000000000000000077777000000000000000770077007700000000001
10000000000000000000000000000000000077000077700000000000077000000000000077000001
10000000000000077000000000000000000770000000000000000000000000000000000000000001
14000000000000000000000000000000000000000000000000000000000000000000000000000041
11111111111111111111111111111111111111111111111111111111111111111111111111111111
