11111111111111111111111111111111111111111111111111111111111111111111111111111111
11111111111111111111111111111111111111111111111111111111111111111111111111111111
14000000000000000000000000000000000000000000000000000000000000000000000000000041
10000770000000000000000000000770000000000000000770000007700000007700000000000001
10000000000000000000000007770000000000000000000000000007700000000000000000000001
10000007700000077000000007770007770077000000007700000770000000000000000000000001
10000007700000007700000000770007700000077000000007700000000000000000000000000001
10000000000077000000000000000770000000000077000000000000077000000077000000000001
10007700000000000000777000000000000000000007700000000077000007700000000000077001
10000770000000000000777000000007700000000000000077000000000007700000007700077001
10000000770007700000077000000000007700000000000077000000000000000000000770077001
10000000000000000000077000000000000700000000000077000000770000000000000000077001
10000007770000000000077700000000000773333333077000077000000000000777000000007001
10000000077007700000000770000000000003333333077000077000000000000777000000000001
10007700000000000007700000000000000003333333000000000000000000000770000000770001
10077700000000000000000000000000007703333333700077000007770000000000000000000001
10077000000077000000007700000000000003333333000000000007700007700000000000000001
10077000000000000000077700000000000003333333000770000000000000000000000000000001
10007007700000000000077007770000000003333333000000000770000000077000000000000001
10007700000770000000000000770000000077000000000007777770000000007000077000000001
10000000000077000000000000777000000000000000000007700077700000007700000000000001
10000000000000000000770000000000000000000000000000000000777000007700000000000001
10000000000000000000000000007770000000000000770000000000077700007770000000000001
10077000000000000000000000007700000000777700777000000000000000777777000077000001
10000000000000770000077000000000000000000000077000000000000000000770000077007001
10000000000000770000000007700000770000000000077000770000007770000000000077000001
10000770000077000000000000000000770000000000077000000770000000000000000000077001
10000000000000000000000000000000000000000000000000000077000000770000000000000001
14000000000000000000000000000000000000000000000000000000000000000000000000000041
11111111111111111111111111111111111111111111111111111111111111111111111111111111
