11111111111111111111111111111111111111111111111111111111111111111111111111111111
11111111111111111111111111111111111111111111111111111111111111111111111111111111
14000000000000000000000000000000000000000000000000000000000000000000000000000041
10007700770000077000000007700000000000000000077000000000000007700007700777000001
10077007777000000077000000000007700000000000770000077700007770000770000777700001
10000007700000000077000000000000000077000000000000077000000000000000000777000001
10000000000000777000000000000000000000000000000000077000000000000000077700000001
10000000000000770000077700007770000000000077000077007700770000000077700000000001
10000000000077770000000077770070000000770077000077000777770000000000000007700001
10007700000077770007700077000777000077000077007700000077770000077000000007700001
10007700000777000000000000000770000000000077000000777770000000007700000000770001
10000000000777000000000000000000077770077000000000077770000000000007700770770001
10000000000077000000000007700000000003333333000000077000007700770000000000777001
10000000000000000000770007700000770003333333000007777000000000770000000000077001
10000007700000000007770007777000000003333333000007777000000000770000000777000001
10000000000000000007700077007700000003333333077007700000000000000000000770000001
10007700000000000000000000007770007703333333077007700077700770007700000000000001
10000000000000007700000000077700000003333333077000000077700000000000000000000001
10000000077000000770000000077770000003333333007777000077770007700000000000000001
10000077700000000777777700077777000000000000000777700000770077700000000000000001
10000077000000007777777700007777770007700000000000770000000077777777700000000001
10000077000000770000007700000007777000000000000000000000000000777777770000077001
10000777000000777000007770000000007000007700000000000000770000007700000077007001
10000777777770077700007700000000007700000770000777007700000000000000007770000001
10000777777000077700000000770000000000000000000077700770000000000000007770000001
10000770077000077700000000770000000007777700770007700000007700000000777770007001
10000000077000007770000000770000007700000000770000000000000770000770000770000001
10000000077007700077000077000000007770007770077000000000000000007700000770000001
14000000000000000000000000000000000000000000000000000000000000000000000000000041
11111111111111111111111111111111111111111111111111111111111111111111111111111111
