11111111111111111111111111111111111111111111111111111111111111111111111111111111
11111111111111111111111111111111111111111111111111111111111111111111111111111111
14400000000000000000000000000000000000000000000000000000000000000000000000000441
10000007700000000777000000000000000000000000770007700000007700000000000077000001
10000000000000000077700000000000000000000000000000000000077000000000000000077001
10000000077700000000700000000000077700007777000000077000000000000000000777777001
10000770007770000000770000000770077770000000000000000000000000000000000007770001
10000000000777000770000000770000000077000000000000000000007770000077000000770001
10000000000777000070000000000007700000000000000000000000077700000000000000007001
10000000007700000077000000000000770000000000000077000077000700077000000000000001
10000000007700077700007770007700077007700000777700077700000770000000000077077001
10000000007700000000000770007770077000000000777700077000000000000000000077077001
10000000000000000077000770000000077003333333000770077000000000007700777777007001
10000000000000000077000770000000000003333333000000000000777000777700000000000001
10000000007700000077000000000000000003333333007700000000077000777700000000000001
10000000000777770000000000000007700003333333000000000077777000007770007777700001
10000770000777777000000770000000000003333333000000000007777700007700000077770001
10000777000077000000000000000000000003333333000000000000077700077700000007700001
10000077700000000000000007700000000003333333000000770000007770077700000000000001
10000007700000770077700007700000000000000000000000770000000770007770000000000001
10000000000770000000777000777007770077770007700000777000000000000077700007700001
10000000000000000000077700077707777000777000000000077700000000077000770000770001
10000000000000770000007700077000770000077000000000007700000000007000077700000001
10000000000770770000007770077000770000000000000000000000777000007700007770000001
10000000000000777007700000000000770077700000000770000000000000000770000070000001
10000000000000000000000000000000000007770000000000000777000000000770000077700001
10000000000770000770000000000000007700000000000000000770000000000770000000770001
10000000007700000000000077000000000000000000770000000000000000000000000000770001
14400000000000000000000000000000000000000000000000000000000000000000000000000441
11111111111111111111111111111111111111111111111111111111111111111111111111111111
