1111111111111111111111111111111111111111111111111111111111111111111111111111111111111111111111111111
1111111111111111111111111111111111111111111111111111111111111111111111111111111111111111111111111111
1440000000000000000000000000000000000000000000000000000000000000000000000000000000000000000000000441
1007700000000000000000007700077700000000777700000000000000007777000000000007770000077000000770000001
1000777770000000000000000000777700000007700770000770000000077770000077000000000000077000000000000001
1000777000770007700007700000777700000007770000000070000000007770000077700000000000077000000000000001
1000770000777007770000000000000770000007777000000777000077000777000077000000000770077000007700770001
1000770000000000777000000000000000000000077000000777000000000077700777000077000770077000007770000001
1000000000000000777700007770000000077000077700000770000000000007700000000000000770077000007770000001
1000000000000000777700007700007770000000077000000000077000770007770000000770077770000077000070000001
1000000000000007777777000000007770000000077000000000077700777007770007700070000077000000000077007001
1007700000000000000007700000000000000000000000770000000000777007770000000077000000000000007777007001
1000000000000000000000000000000000000000000770033333330000077007770000000000007770000077700777000001
1000000000077700077000000000007777777007700000033333330000000007770000000777000000000007770077000001
1000000000777007700077770000000077777700000000033333337700000000777000000077700000000007770077700001
1000077000770000000000777000000000077770000077733333337000000000000007700000770000000000000077700001
1000000000000000077700777000077700000770000077033333337700000077700000000000000000000077000007770001
1000000000007700077000077000000770000070000000033333337770000007700777000077000770000007700007770001
1000000000007707700000077770000000000077000000733333330770000000700777700077000077000000770077000001
1000000000007700000000770077000000000077000000000000000000007700770777000000000000000000000000000001
1000077000000000000000000077707770000077000770077000777000000000000777000000077700077007700000007001
1000077000000000000000000770007700000077000770000000007700000077077700077000777007700077700000000001
1000077000770000000007707770007700000077700000000000000000000000777770000000777000000077000777700001
1000000000000000000000007700000000777077770000000077000000000000770077700000077700000000000777700001
1000000000000000000777000000000000770077770000000000000000000000000000770000000770000770000777000001
1007770000000000000007700000000000770077770000000000000007700000000000077007700000000777000077000001
1000777007700000770000000007770000000007700000770000000007700000000000077700000007777700077000000001
1000077007700000000077000000000000000000000000000777000000000770000000000000000770000000770000000001
1440000000000000000000000000000000000000000000000000000000000000000000000000000000000000000000000441
1111111111111111111111111111111111111111111111111111111111111111111111111111111111111111111111111111
