11111111111111111111111111111111111111111111111111111111111111111111111111111111
11111111111111111111111111111111111111111111111111111111111111111111111111111111
14400000000000000000000000000000000000000000000000000000000000000000000000000441
10000000000000000000000000000000000000000000770000000000000000000000000000000001
10000000000000000000000000000000000000000000000000000000000000000000000000000001
10000000000770000000000000000000000000000000000000000077000000770000077000000001
10000000000000000000000770000000000000000000000770000000000000000000000000077001
10000000000000000000000000000000000000000000000000000000000000000000000000000001
10000000007700770000770000000000000077000000000000000000000000000000000000000001
10000000000000070000000000000000000000000000000000000000000007700007700000000001
10000000000000077000000000000000007700000000000000000000000770000000000000000001
10000000000000000000000000077000000000000000000000000077000000000000000000000001
10007700000000000000007700000000000003333333000000000000000000000000000000000001
10000000000000000000000000000000000003333333000000000000000000000000000000000001
10000000000000000000000000077000000003333333000000770000000000000000000000000001
10000000000000007700000000000000000003333333000000000000000007700000000000000001
10000770000000000007700770000000000003333333007700000000007707707700000000000001
10000000000000000000000000000000000003333333000000000000000007700000000000000001
10000000000000000000000000000770000003333333000000000000000000000000000000000001
10000000000007700000000000000000000770000000000000000007700000000000007770000001
10000000000000700000000000000000000000000000000000000000000000000000007700770001
10000000000000770000000000000000077000000000000000077000000000000000000700000001
10000000000000770077000000000000000000000000000000000000000000770000007770000001
10000000000000770000000770000000000000000000000000000000000000000000007700000001
10000000000000000000000000007700000077000000000000000000000000000000000000000001
10000000000000000000000000000000000007000000000000000000000000000000000007700001
10000000000000000000000000000000000007700000077000000000000000000000000000000001
10000007700000000000000000000000000000000000000000000000000000000000000000000001
14400000000000000000000000000000000000000000000000000000000000000000000000000441
11111111111111111111111111111111111111111111111111111111111111111111111111111111
