11111111111111111111111111111111111111111111111111111111111111111111111111111111
11111111111111111111111111111111111111111111111111111111111111111111111111111111
14000000000000000000000000000000000000000000000000000000000000000000000000000041
10077700000000007700000000000770077000007700007700000007700077000077000000000001
10007777700770000000770000000770000000000000000700000000700007770000000000007001
10007700000000000000000000000770000000000000000777000000770000777000000000770001
10000000077000000000000000000000770000000000077777770000770000077000770000770001
10000000000077700770000000000000000000000000000777777000077700000000777000077001
10000770000777000000007700000000000000007700000077777000000770000000770000007001
10000770000777000000000000000000077000000000000000777000000770007700000007777001
10000770000007700000077777700000000000000000077700777000000770007700000007777001
10000077770000000770007770000000000000000077007700077000000777000000077007770001
10000077777000000000000770000000777003333333007700007770000077700000000007770001
10000000777700000000000000000000770003333333000000007777000007700000000777700001
10077000077700000007700000770000770003333333077000007700077000770000000777700001
10077700000000000000000077000000770003333333000000000000077000000077770077770001
10007700000077000000000000000000000003333333000000770000000000000077777000777001
10007770000007700000000000000000000003333333700000070000000000000077777700777001
10007700000000000000770000000007700003333333700000077700770077700000777007777001
10000000770000000000770000000000000000000000770000000770077000770000077000077001
10000000000000000000000000000000000000000000000000000000007000770000077700000001
10007700000777000770000770000000770000777007700077700000007700777000777007700001
10007700000770000000000770000000000777007700000000000000007777777700000007700001
10007700077000007700000770000077700077000000077000000000000777700770000000000001
10000000000077700700000777000000000007000000000007770077000077700000000000000001
10000000000077000777000777700000000007700000000007770000000000777000007700000001
10007700000000000007700000770000000007700000000000770000000000007700000000000001
10000770000000000007700077770000000770000000077000770000777000000770000077000001
14000000000000000000000000000000000000000000000000000000000000000000000000000041
11111111111111111111111111111111111111111111111111111111111111111111111111111111
